ClearPathCracker			KEYWORD1
findNearestDetent		KEYWORD1
findAllDetents			KEYWORD1
TryCombination			KEYWORD1
TryAllPossibleCombinations	KEYWORD1

CMDRES				KEYWORD2
backlash_Comp			KEYWORD2
aftermovedwell			KEYWORD2
solveVelocity			KEYWORD2
solveAccel			KEYWORD2
NumDetents			KEYWORD2
TeknicStepController	KEYWORD1
Start	KEYWORD1
Stop	KEYWORD1
PulseClearPath	KEYWORD1
disable	KEYWORD1
enable	KEYWORD1
getSpeed	KEYWORD1
readHLFB	KEYWORD1
altSpeed	KEYWORD1
attach	KEYWORD1
stopMove	KEYWORD1
calcSteps	KEYWORD1
getDirPin	KEYWORD1
move	KEYWORD1
Direction	KEYWORD1
commandDone	KEYWORD1
getCommandedPosition	KEYWORD1
_Apin	KEYWORD2
_Bpin	KEYWORD2
_Epin	KEYWORD2
_Hpin	KEYWORD2
_commandX	KEYWORD2
_direction	KEYWORD2
_BurstX		KEYWORD2
_absPosition	KEYWORD2
StepClearPath	KEYWORD1
setMaxVel	KEYWORD1
setMaxAccel	KEYWORD1